H 1 1111	MrNFEN	2 MEDIUMS + 3 HARDS! - Trials Fusion w_ Nick.mp4
Jumps and Cars	MrNFEN	2 MEDIUMS + 3 HARDS! - Trials Fusion w_ Nick.mp4
obsession ++	MrNFEN	2 MEDIUMS + 3 HARDS! - Trials Fusion w_ Nick.mp4
A DERBY OF SORTS	MrNFEN	2 MEDIUMS + 3 HARDS! - Trials Fusion w_ Nick.mp4
Cold Stones	MrSparkles	2 MEDIUMS + 3 HARDS! - Trials Fusion w_ Nick.mp4
Ruined Expedition	Player Mr$parklyPunts wins!	AIN'T EASY BEING STEEZY - Trials Fusion w_ Nick.mp4
ATVL‘ITOP SPEED RUN	MrSparkles	AIN'T EASY BEING STEEZY - Trials Fusion w_ Nick.mp4
Bowbav	MrSparkles	AIN'T EASY BEING STEEZY - Trials Fusion w_ Nick.mp4
TRIALS EVOUTION	MrNFEN	AIN'T EASY BEING STEEZY - Trials Fusion w_ Nick.mp4
I Whatever	MrNFEN	ALIENS - Trials Fusion w_ Nick.mp4
FIRST ENDURO	MrNFEN	ALIENS - Trials Fusion w_ Nick.mp4
Shade in the blue H	MrNFEN	ALIENS - Trials Fusion w_ Nick.mp4
"Kuroki sawu"	MrSparkles	ALIENS - Trials Fusion w_ Nick.mp4
Hangar 18	MrNFEN	ALIENS - Trials Fusion w_ Nick.mp4
Lil' Boat Trip Too	MrNFEN	ALL I HAVE TO SAY - Trials Fusion w_ Nick.mp4
The Temple of Horus	MrNFEN	ALL I HAVE TO SAY - Trials Fusion w_ Nick.mp4
N1 L8-Triuls HD'ish	MrNFEN	ALL I HAVE TO SAY - Trials Fusion w_ Nick.mp4
Pruecurro	MrSparkles	ALL I HAVE TO SAY - Trials Fusion w_ Nick.mp4
Broken City	MrSparkles	ALL TIED UP - Trials Fusion w_ Nick.mp4
7 [DD] Durude	MrNFEN	ALL TIED UP - Trials Fusion w_ Nick.mp4
Xenon	MrSparkles	ALL TIED UP - Trials Fusion w_ Nick.mp4
Teqqui	MrNFEN	ALL TIED UP - Trials Fusion w_ Nick.mp4
Viper walch ur slap	MrNFEN	ALL TIED UP - Trials Fusion w_ Nick.mp4
Cargo	MrNFEN	AN INCLINE  - Trials Fusion w_ Nick.mp4
Club Climb Cube	MrNFEN	AN INCLINE  - Trials Fusion w_ Nick.mp4
Submerged	MrSparkles	AN INCLINE  - Trials Fusion w_ Nick.mp4
N 1 L8 HD Warehouse	MrSparkles	ANNIHILATED - Trials Fusion w_ Nick.mp4
N1 L3-HD'UcioUs	MrNFEN	ANNIHILATED - Trials Fusion w_ Nick.mp4
' [P] MU} HD	MrNFEN	ANNIHILATED - Trials Fusion w_ Nick.mp4
Crater Noc	MrNFEN	ANNIHILATED - Trials Fusion w_ Nick.mp4
"WE BEGIN 3"	MrNFEN	ANNIHILATED - Trials Fusion w_ Nick.mp4
(olurse en \a piscino	MrNFEN	ANNIHILATED - Trials Fusion w_ Nick.mp4
Observatory	MrSparkles	ANOTHER MAP FOR US - Trials Fusion w_ Nick.mp4
n ROCK LOBSTER :1	MrSparkles	ANOTHER MAP FOR US - Trials Fusion w_ Nick.mp4
Sparklez v mrNFEN	MrSparkles	ANOTHER MAP FOR US - Trials Fusion w_ Nick.mp4
BOMBULAR 3	MrSparkles	ANOTHER MAP FOR US - Trials Fusion w_ Nick.mp4
ramps and smff	MrSparkles	ANTI STEEZE - Trials Fusion w_ Nick.mp4
capsuel course	MrNFEN	ANTI STEEZE - Trials Fusion w_ Nick.mp4
Very Observcnl	MrSparkles	ANTI STEEZE - Trials Fusion w_ Nick.mp4
Breokback Hotel	MrNFEN	ANTI STEEZE - Trials Fusion w_ Nick.mp4
up in the air	MrNFEN	ANTI STEEZE - Trials Fusion w_ Nick.mp4
Inrhe wall	MrNFEN	BECOMING BIONICLES - Trials Fusion w_ Nick.mp4
Luck of Imagination	MrNFEN	BECOMING BIONICLES - Trials Fusion w_ Nick.mp4
Mounluin Monastery	MrNFEN	BECOMING BIONICLES - Trials Fusion w_ Nick.mp4
Natural Ez	MrNFEN	BECOMING BIONICLES - Trials Fusion w_ Nick.mp4
Asleroid Run	MrSparkles	BEST WORST GAME - Trials Fusion w_ Nick.mp4
The Quick Hop	MrSparkles	BEST WORST GAME - Trials Fusion w_ Nick.mp4
River Run	MrNFEN	BEST WORST GAME - Trials Fusion w_ Nick.mp4
1 \ove you	MrNFEN	BEST WORST GAME - Trials Fusion w_ Nick.mp4
N1L8 NEW HORIZON	MrNFEN	BEST WORST GAME - Trials Fusion w_ Nick.mp4
X-Supercross FINAL RESULTS	MrNFEN	BEST WORST GAME - Trials Fusion w_ Nick.mp4
Quick One (Pit Viper)	MrSparkles	BLOOD PACT - Trials Fusion w_ Nick.mp4
Bridge of no Relurn	MrSparkles	BLOOD PACT - Trials Fusion w_ Nick.mp4
Island of the oblivion #	MrSparkles	BLOOD PACT - Trials Fusion w_ Nick.mp4
NOODZ	MrNFEN	BLOOD PACT - Trials Fusion w_ Nick.mp4
First	MrNFEN	BON JOVI - Trials Fusion w_ Nick.mp4
lgBZ Blue line	MrSparkles	BON JOVI - Trials Fusion w_ Nick.mp4
Around	MrSparkles	BON JOVI - Trials Fusion w_ Nick.mp4
3’ mock Theory 10	MrSparkles	BON JOVI - Trials Fusion w_ Nick.mp4
WTF 2	MrNFEN	C'EST LA STEEZ - Trials Fusion w_ Nick.mp4
iuso boxes ..... T.G	MrNFEN	C'EST LA STEEZ - Trials Fusion w_ Nick.mp4
monop madness	MrNFEN	C'EST LA STEEZ - Trials Fusion w_ Nick.mp4
The SCARY moments	MrNFEN	CHAMPIONSHIP 2017 - Trials Fusion w_ Nick.mp4
2017	MrSparkles	CHAMPIONSHIP 2017 - Trials Fusion w_ Nick.mp4
Woodville	MrSparkles	CHAMPIONSHIP 2017 - Trials Fusion w_ Nick.mp4
CHAMPIONSHIP 2017	Player Mr$pork|yPanfs wins!	CHAMPIONSHIP 2017 - Trials Fusion w_ Nick.mp4
no checkpoints	MrNFEN	CHIVALRY ISN'T DEAD - Trials Fusion w_ Nick.mp4
UKr Arlic Quoﬂer FIX	MrSparkles	CHIVALRY ISN'T DEAD - Trials Fusion w_ Nick.mp4
Whole Iona Lava	MrNFEN	CHIVALRY ISN'T DEAD - Trials Fusion w_ Nick.mp4
Below Zero	MrNFEN	CHIVALRY ISN'T DEAD - Trials Fusion w_ Nick.mp4
X-Supercross FINAL RESULTS	Player Mr$parklyPanrs wins!	CHIVALRY ISN'T DEAD - Trials Fusion w_ Nick.mp4
Flow Rider	MrSparkles	CLOUDY WITH A CHANCE OF MEMELORD - Trials Fusion w_ Nick.mp4
Donkey Sky Full	MrNFEN	CLOUDY WITH A CHANCE OF MEMELORD - Trials Fusion w_ Nick.mp4
[Queen Of The Wood]	MrNFEN	CLOUDY WITH A CHANCE OF MEMELORD - Trials Fusion w_ Nick.mp4
Cloudy, with a chance of	MrSparkles	CLOUDY WITH A CHANCE OF MEMELORD - Trials Fusion w_ Nick.mp4
sonds'orm	MrNFEN	COLORBLIND - Trials Fusion w_ Nick.mp4
Slicks ardic	MrSparkles	COLORBLIND - Trials Fusion w_ Nick.mp4
MyTruck	MrSparkles	COLORBLIND - Trials Fusion w_ Nick.mp4
X-Supercross FINAL RESULTS	MrSparkles	COLORBLIND - Trials Fusion w_ Nick.mp4
Space Station Alpha	MrNFEN	COMMANDO PRO - Trials Fusion w_ Nick.mp4
L/ 'Brighfsida’	MrSparkles	COMMANDO PRO - Trials Fusion w_ Nick.mp4
Viper rocks SPEED RUN	MrSparkles	COMMANDO PRO - Trials Fusion w_ Nick.mp4
g} x keeping ivsmoooclh	MrNFEN	COMMANDO PRO - Trials Fusion w_ Nick.mp4
X-Supercross FINAL RESULTS	MrNFEN	COMMANDO PRO - Trials Fusion w_ Nick.mp4
JOU JOU 1”	MrSparkles	COMMANDO PRO - Trials Fusion w_ Nick.mp4
[UKR] Midnighl Speedrun	MrSparkles	CONCRETE ANGEL - Trials Fusion w_ Nick.mp4
idonvknowwhclimdoing	MrSparkles	CONCRETE ANGEL - Trials Fusion w_ Nick.mp4
Above Eudh	MrNFEN	CONCRETE ANGEL - Trials Fusion w_ Nick.mp4
Concrete Dreams	MrNFEN	CONCRETE ANGEL - Trials Fusion w_ Nick.mp4
Arvic rUins(sing|ep|uyer	MrNFEN	DEATH STAR - Trials Fusion w_ Nick.mp4
. Den"! smr	MrNFEN	DEATH STAR - Trials Fusion w_ Nick.mp4
(:55 Mount Chi||y	MrSparkles	DEATH STAR - Trials Fusion w_ Nick.mp4
[Vegas] Technical Tires	MrNFEN	DEATH STAR - Trials Fusion w_ Nick.mp4
TONADOS STEINBRUCH	MrSparkles	DEATH STAR - Trials Fusion w_ Nick.mp4
Bungalow Beach	MrNFEN	DNFEN THE GREAT - Trials Fusion w_ Nick.mp4
Cave Dweller	MrSparkles	DNFEN THE GREAT - Trials Fusion w_ Nick.mp4
Coven Ops	MrSparkles	DNFEN THE GREAT - Trials Fusion w_ Nick.mp4
Mind the Gap	MrSparkles	DNFEN THE GREAT - Trials Fusion w_ Nick.mp4
"CRATER FACE"	MrNFEN	DON'T PLAY THIS VIDEO - Trials Fusion w_ Nick.mp4
Don‘t play this track!	MrSparkles	DON'T PLAY THIS VIDEO - Trials Fusion w_ Nick.mp4
Sky Cull	MrSparkles	DON'T PLAY THIS VIDEO - Trials Fusion w_ Nick.mp4
Donkey gapsl	MrSparkles	DON'T PLAY THIS VIDEO - Trials Fusion w_ Nick.mp4
Sumnu Raga	MrNFEN	DONKEY CIRCUS - Trials Fusion w_ Nick.mp4
ITS JUST SPEED BUMPS	MrNFEN	DONKEY CIRCUS - Trials Fusion w_ Nick.mp4
Donkey Circusmx)	MrSparkles	DONKEY CIRCUS - Trials Fusion w_ Nick.mp4
SB: Kinelic Keyfrumes	MrNFEN	DONKEY CIRCUS - Trials Fusion w_ Nick.mp4
Racky Coast	MrNFEN	DONKEY DERBY - Trials Fusion w_ Nick.mp4
Good Game Live MELBOURNE	MrNFEN	DONKEY DERBY - Trials Fusion w_ Nick.mp4
Donkey Derby	MrSparkles	DONKEY DERBY - Trials Fusion w_ Nick.mp4
Manufacluring	MrNFEN	DONKEY MADNESS - Trials Fusion w_ Nick.mp4
SandSbrmWiper)	MrSparkles	DONKEY MADNESS - Trials Fusion w_ Nick.mp4
Tired Night Way	MrSparkles	DONKEY MADNESS - Trials Fusion w_ Nick.mp4
Donkey Madness	MrNFEN	DONKEY MADNESS - Trials Fusion w_ Nick.mp4
3 ouyeuh	MrSparkles	DOUBLE DNF - Trials Fusion w_ Nick.mp4
Die RUine	MrSparkles	DOUBLE DNF - Trials Fusion w_ Nick.mp4
Zombie 2	MrNFEN	DOUBLE DNF - Trials Fusion w_ Nick.mp4
Sky Machine 201 a	MrSparkles	DOUBLE DNF - Trials Fusion w_ Nick.mp4
ANHREWORK LAGOON	MrSparkles	DOUBLE DOWN MISTAKES - Trials Fusion w_ Nick.mp4
IBUKING the ride'	MrNFEN	DOUBLE DOWN MISTAKES - Trials Fusion w_ Nick.mp4
ATV;HILLCL|MB	MrSparkles	DOUBLE DOWN MISTAKES - Trials Fusion w_ Nick.mp4
/ Orange World	MrSparkles	DOUBLE DOWN MISTAKES - Trials Fusion w_ Nick.mp4
|:|ARTIC VIPER| :|	MrNFEN	DOUBLE DOWN MISTAKES - Trials Fusion w_ Nick.mp4
Dunes Day	MrSparkles	DOUBLE OR NOTHING - Trials Fusion w_ Nick.mp4
Cold Embrace	MrNFEN	DOUBLE OR NOTHING - Trials Fusion w_ Nick.mp4
Going Home	MrNFEN	DOUBLE OR NOTHING - Trials Fusion w_ Nick.mp4
Lute Arrival	MrNFEN	DOUBLE OR NOTHING - Trials Fusion w_ Nick.mp4
MBS‘TWICE	MrSparkles	DOWN TO THE WIRE - Trials Fusion w_ Nick.mp4
Fire Rage	MrSparkles	DOWN TO THE WIRE - Trials Fusion w_ Nick.mp4
Blue Shock	MrNFEN	DOWN TO THE WIRE - Trials Fusion w_ Nick.mp4
An der irischen Luh	MrNFEN	DOWN TO THE WIRE - Trials Fusion w_ Nick.mp4
MX Madness	MrSparkles	DR. SEUSS - Trials Fusion w_ Nick.mp4
Albi 6	MrSparkles	DR. SEUSS - Trials Fusion w_ Nick.mp4
Trial Day ( 3 )	MrSparkles	DR. SEUSS - Trials Fusion w_ Nick.mp4
X-Supercross FINAL RESULTS	MrSparkles	DR. SEUSS - Trials Fusion w_ Nick.mp4
{1 Quick Hop Two	MrSparkles	EASY BREEZY STEEZY BEAUTIFUL BIKER BOY - Trials Fusion w_ Nick.mp4
Stupid uber climb	MrNFEN	EASY BREEZY STEEZY BEAUTIFUL BIKER BOY - Trials Fusion w_ Nick.mp4
Sign's	MrSparkles	EASY BREEZY STEEZY BEAUTIFUL BIKER BOY - Trials Fusion w_ Nick.mp4
Concrete Rush	MrNFEN	EASY BREEZY STEEZY BEAUTIFUL BIKER BOY - Trials Fusion w_ Nick.mp4
Sky trials	MrSparkles	EASY BREEZY STEEZY BEAUTIFUL BIKER BOY - Trials Fusion w_ Nick.mp4
morning run	MrNFEN	ELON STEEZ - Trials Fusion w_ Nick.mp4
GoonodIl	MrSparkles	ELON STEEZ - Trials Fusion w_ Nick.mp4
FK Loguns Run Alpha line	MrSparkles	ELON STEEZ - Trials Fusion w_ Nick.mp4
[[SPIDER RABBITI]	MrSparkles	ELON STEEZ - Trials Fusion w_ Nick.mp4
ALEX BIG AIR	MrSparkles	EVIL TRON - Trials Fusion w_ Nick.mp4
Roach Hi” MX	MrNFEN	EVIL TRON - Trials Fusion w_ Nick.mp4
Ice age 2098	MrSparkles	EVIL TRON - Trials Fusion w_ Nick.mp4
V59 Orzone	MrNFEN	EVIL TRON - Trials Fusion w_ Nick.mp4
Hard Blue Water	MrSparkles	EXPLOSIVE ANGER - Trials Fusion w_ Nick.mp4
Home For Christmas	MrSparkles	EXPLOSIVE ANGER - Trials Fusion w_ Nick.mp4
Blue chrisrmas ++	MrNFEN	EXPLOSIVE ANGER - Trials Fusion w_ Nick.mp4
N 1 LIB-Explosive Xmas	MrNFEN	EXPLOSIVE ANGER - Trials Fusion w_ Nick.mp4
ATVUMOUNTAIN ADVENTUREH	MrNFEN	EXTREMELY STUCK - Trials Fusion w_ Nick.mp4
Steamy Desert	MrNFEN	EXTREMELY STUCK - Trials Fusion w_ Nick.mp4
TOTAL trial	MrNFEN	EXTREMELY STUCK - Trials Fusion w_ Nick.mp4
[T7] Donkey Speed	MrSparkles	EXTREMELY STUCK - Trials Fusion w_ Nick.mp4
/ Les! Day or schoonn	MrSparkles	FLAVORTOWN - Trials Fusion w_ Nick.mp4
The Hard Mine	MrNFEN	FLAVORTOWN - Trials Fusion w_ Nick.mp4
I992 B|ue line 3	MrSparkles	FLAVORTOWN - Trials Fusion w_ Nick.mp4
Dark Speedrun (HARD)	MrSparkles	FLAVORTOWN - Trials Fusion w_ Nick.mp4
crush zone	MrNFEN	FREE FALLING - Trials Fusion w_ Nick.mp4
Super hack	MrSparkles	FREE FALLING - Trials Fusion w_ Nick.mp4
Go on in the Sky	MrNFEN	FREE FALLING - Trials Fusion w_ Nick.mp4
Y59 Chronos A	MrNFEN	FREE FALLING - Trials Fusion w_ Nick.mp4
X-Supercross FINAL RESULTS	MrNFEN	FREE FALLING - Trials Fusion w_ Nick.mp4
Minimi V5	MrSparkles	GOTTA GO FAST - Trials Fusion w_ Nick.mp4
ATV U "ADVENTURE"	MrSparkles	GOTTA GO FAST - Trials Fusion w_ Nick.mp4
Rumble in the Jungle	MrNFEN	GOTTA GO FAST - Trials Fusion w_ Nick.mp4
Green Hill Zone	MrSparkles	GOTTA GO FAST - Trials Fusion w_ Nick.mp4
f TOO FAST”!	MrNFEN	GREATEST MAP EVER - Trials Fusion w_ Nick.mp4
Panel to a new life	MrSparkles	GREATEST MAP EVER - Trials Fusion w_ Nick.mp4
FulurePlay	MrSparkles	GREATEST MAP EVER - Trials Fusion w_ Nick.mp4
Time°Prima	MrNFEN	GREATEST MAP EVER - Trials Fusion w_ Nick.mp4
LOCKED CHAINS	MrSparkles	GUCCI HANES - Trials Fusion w_ Nick.mp4
Quick Desert Roach	MrNFEN	GUCCI HANES - Trials Fusion w_ Nick.mp4
[[SPRING MOUNTAINH	MrSparkles	GUCCI HANES - Trials Fusion w_ Nick.mp4
Outlow's Grotto	MrSparkles	GUCCI HANES - Trials Fusion w_ Nick.mp4
World of boxes	MrNFEN	GUY FIERI DUNE - Trials Fusion w_ Nick.mp4
Wood and sand	MrSparkles	GUY FIERI DUNE - Trials Fusion w_ Nick.mp4
Biotech frontiers Cove	MrSparkles	GUY FIERI DUNE - Trials Fusion w_ Nick.mp4
((Deser! Rabbi!”	MrNFEN	GUY FIERI DUNE - Trials Fusion w_ Nick.mp4
Trials Edge	MrNFEN	HALLOWEENIES - Trials Fusion w_ Nick.mp4
j Track ior	MrNFEN	HALLOWEENIES - Trials Fusion w_ Nick.mp4
._ / "Slurry Nighf"	MrSparkles	HALLOWEENIES - Trials Fusion w_ Nick.mp4
NO FriHs Driveiine	MrSparkles	HALLOWEENIES - Trials Fusion w_ Nick.mp4
::Ancesior::	MrSparkles	HAMSTER BALL  - Trials Fusion w_ Nick.mp4
Cave Mech	MrSparkles	HAMSTER BALL  - Trials Fusion w_ Nick.mp4
Donkey's Road Map (ﬁx)	MrNFEN	HAMSTER BALL  - Trials Fusion w_ Nick.mp4
Y59 Eurolriuls V2	MrNFEN	HAMSTER BALL  - Trials Fusion w_ Nick.mp4
Desert Oasis	MrSparkles	HAN SHOT FIRST - Trials Fusion w_ Nick.mp4
Wacky Wednesday	MrNFEN	HAN SHOT FIRST - Trials Fusion w_ Nick.mp4
fill Ihen ++	MrSparkles	HAN SHOT FIRST - Trials Fusion w_ Nick.mp4
STAR WARS MOS EISLEY	MrSparkles	HAN SHOT FIRST - Trials Fusion w_ Nick.mp4
MyTruck	MrSparkles	HEAVY LIFTING - Trials Fusion w_ Nick.mp4
There & Buck	MrSparkles	HEAVY LIFTING - Trials Fusion w_ Nick.mp4
Tough Downhill Jumps	MrNFEN	HEAVY LIFTING - Trials Fusion w_ Nick.mp4
Speedrun vo|ccnik	MrSparkles	HEAVY LIFTING - Trials Fusion w_ Nick.mp4
MyTrack zxs	MrSparkles	HERE'S JOHNNY - Trials Fusion w_ Nick.mp4
. ‘ Orange Mud	MrSparkles	HERE'S JOHNNY - Trials Fusion w_ Nick.mp4
scoﬂold climb	MrSparkles	HERE'S JOHNNY - Trials Fusion w_ Nick.mp4
GR 1 7 Speedclimb	MrNFEN	HERE'S JOHNNY - Trials Fusion w_ Nick.mp4
Club Climb Cube	MrSparkles	HERE'S JOHNNY - Trials Fusion w_ Nick.mp4
X-Supercross FINAL RESULTS	MrSparkles	HERE'S JOHNNY - Trials Fusion w_ Nick.mp4
[RLTA] Almost Famous	MrNFEN	HOLLYWOO - Trials Fusion w_ Nick.mp4
AA_FuiI Proof	MrSparkles	HOLLYWOO - Trials Fusion w_ Nick.mp4
Persistent Wuy	MrSparkles	HOLLYWOO - Trials Fusion w_ Nick.mp4
Oh, more Cubes‘	MrNFEN	HOLLYWOO - Trials Fusion w_ Nick.mp4
THANK YOU drive thru	MrSparkles	HOT DOGS - Trials Fusion w_ Nick.mp4
snowy hill climb	MrNFEN	HOT DOGS - Trials Fusion w_ Nick.mp4
Scrunyu	MrSparkles	HOT DOGS - Trials Fusion w_ Nick.mp4
Inﬂux	MrSparkles	HOT DOGS - Trials Fusion w_ Nick.mp4
604 New Trials?	MrNFEN	HOT DOGS - Trials Fusion w_ Nick.mp4
III BUiId #2	MrNFEN	I DIDN'T BREAK MY CONTROLLER - Trials Fusion w_ Nick.mp4
Ho! Champion Racers	MrNFEN	I DIDN'T BREAK MY CONTROLLER - Trials Fusion w_ Nick.mp4
B.I.K.E Dynamics Lab 2	MrNFEN	I DIDN'T BREAK MY CONTROLLER - Trials Fusion w_ Nick.mp4
evening mist	MrNFEN	I DIDN'T BREAK MY CONTROLLER - Trials Fusion w_ Nick.mp4
X-Supercross FINAL RESULTS	MrNFEN	I DIDN'T BREAK MY CONTROLLER - Trials Fusion w_ Nick.mp4
Cop'oinSparklez	MrNFEN	I HAVE MY OWN MAP - Trials Fusion w_ Nick.mp4
‘ FIRE	MrNFEN	I HAVE MY OWN MAP - Trials Fusion w_ Nick.mp4
Trials 8?er 2	MrNFEN	I HAVE MY OWN MAP - Trials Fusion w_ Nick.mp4
Skyﬁne	MrSparkles	I HAVE MY OWN MAP - Trials Fusion w_ Nick.mp4
"cosmopolis"	MrNFEN	I'M A COMPUTER - Trials Fusion w_ Nick.mp4
ISS 3000	MrSparkles	I'M A COMPUTER - Trials Fusion w_ Nick.mp4
"Z "idylle"	MrSparkles	I'M A COMPUTER - Trials Fusion w_ Nick.mp4
"Nocfurnul"	MrNFEN	I'M A COMPUTER - Trials Fusion w_ Nick.mp4
Raincoresr	MrSparkles	I'M BACK - Trials Fusion w_ Nick.mp4
Shun SpestUn Viper	MrNFEN	I'M BACK - Trials Fusion w_ Nick.mp4
CUBE 2	MrSparkles	I'M BACK - Trials Fusion w_ Nick.mp4
Marsh	MrSparkles	I'M BACK - Trials Fusion w_ Nick.mp4
Insane in lhe Mainframe	MrSparkles	I'M BRINGING STEEZY BACK - Trials Fusion w_ Nick.mp4
Super Roach	MrNFEN	I'M BRINGING STEEZY BACK - Trials Fusion w_ Nick.mp4
oddity	MrNFEN	I'M BRINGING STEEZY BACK - Trials Fusion w_ Nick.mp4
Hil lhe bricks	MrSparkles	I'M BRINGING STEEZY BACK - Trials Fusion w_ Nick.mp4
2 00 + Speed Run	MrNFEN	I'M BRINGING STEEZY BACK - Trials Fusion w_ Nick.mp4
BD Desert SpeedrUn	MrSparkles	I'M ON FIRE - Trials Fusion w_ Nick.mp4
/ viper medium mack 93	MrNFEN	I'M ON FIRE - Trials Fusion w_ Nick.mp4
Sedor- 1 2	MrSparkles	I'M ON FIRE - Trials Fusion w_ Nick.mp4
Temple 0‘ Aquarius	MrSparkles	ICE CREAM - Trials Fusion w_ Nick.mp4
ATVZICE—CREAM	MrSparkles	ICE CREAM - Trials Fusion w_ Nick.mp4
-/ Simple Ohstocles	MrSparkles	ICE CREAM - Trials Fusion w_ Nick.mp4
The Wreck	MrSparkles	ICE CREAM - Trials Fusion w_ Nick.mp4
QuickRun	MrNFEN	IMPOSSIBLE CLIMB - Trials Fusion w_ Nick.mp4
donkey truck	MrNFEN	IMPOSSIBLE CLIMB - Trials Fusion w_ Nick.mp4
Blue eyes open	MrSparkles	IMPOSSIBLE CLIMB - Trials Fusion w_ Nick.mp4
OHrooder	MrNFEN	IMPOSSIBLE CLIMB - Trials Fusion w_ Nick.mp4
Roach + Power + Jumps	MrSparkles	IMPOSSIBLE JUMP - Trials Fusion w_ Nick.mp4
‘kfc. , hmmmm	MrSparkles	IMPOSSIBLE JUMP - Trials Fusion w_ Nick.mp4
[RH] The Void	MrNFEN	IMPOSSIBLE JUMP - Trials Fusion w_ Nick.mp4
Concrete Hillside (Flow)	MrNFEN	IMPOSSIBLE JUMP - Trials Fusion w_ Nick.mp4
Speedo	MrNFEN	IMPOSSIBLE STAIRS - Trials Fusion w_ Nick.mp4
The Bout	MrSparkles	IMPOSSIBLE STAIRS - Trials Fusion w_ Nick.mp4
Le perv	MrNFEN	IMPOSSIBLE STAIRS - Trials Fusion w_ Nick.mp4
Viper nighos	MrNFEN	IMPOSSIBLE STAIRS - Trials Fusion w_ Nick.mp4
Snow Coaster	MrSparkles	IMPROV - Trials Fusion w_ Nick.mp4
Big Rock	MrSparkles	IMPROV - Trials Fusion w_ Nick.mp4
Gritty Grono	MrSparkles	IMPROV - Trials Fusion w_ Nick.mp4
Railyurd Boogie	MrSparkles	IMPROV - Trials Fusion w_ Nick.mp4
Holleluiuh mountain ++	MrSparkles	IMPROV - Trials Fusion w_ Nick.mp4
lnduTricls	MrSparkles	IN A PICKLE - Trials Fusion w_ Nick.mp4
Long way	MrSparkles	IN A PICKLE - Trials Fusion w_ Nick.mp4
/ 'No Gas Deser' BMX	MrSparkles	IN A PICKLE - Trials Fusion w_ Nick.mp4
Down 8- Around EZ	MrNFEN	IN A PICKLE - Trials Fusion w_ Nick.mp4
machine	MrNFEN	IT'S TRICKY - Trials Fusion w_ Nick.mp4
Cold Peak	MrSparkles	IT'S TRICKY - Trials Fusion w_ Nick.mp4
A. Konogawo	MrSparkles	IT'S TRICKY - Trials Fusion w_ Nick.mp4
Concealed	MrSparkles	IT'S TRICKY - Trials Fusion w_ Nick.mp4
buteuu	MrNFEN	JARDONTOWN - Trials Fusion w_ Nick.mp4
I Fleming Rocks	MrSparkles	JARDONTOWN - Trials Fusion w_ Nick.mp4
Pil viper (v2)	MrNFEN	JARDONTOWN - Trials Fusion w_ Nick.mp4
Ship wreck	MrNFEN	LEAVE BRITNEY ALONE - Trials Fusion w_ Nick.mp4
Randomness	MrSparkles	LEAVE BRITNEY ALONE - Trials Fusion w_ Nick.mp4
BIock Theory 6	MrNFEN	LEAVE BRITNEY ALONE - Trials Fusion w_ Nick.mp4
Y59 Fusion	MrNFEN	LEAVE BRITNEY ALONE - Trials Fusion w_ Nick.mp4
Mountain Speedrun..,	MrNFEN	LIL DNF BOY - Trials Fusion w_ Nick.mp4
Alone	MrNFEN	LIL DNF BOY - Trials Fusion w_ Nick.mp4
Modern day Viper	MrSparkles	LIL DNF BOY - Trials Fusion w_ Nick.mp4
Entrepél	MrNFEN	LIL DNF BOY - Trials Fusion w_ Nick.mp4
bungullois	MrNFEN	LONGEST MAP EVER - Trials Fusion w_ Nick.mp4
Trapped	MrNFEN	LONGEST MAP EVER - Trials Fusion w_ Nick.mp4
Boomblasl	MrNFEN	LONGEST MAP EVER - Trials Fusion w_ Nick.mp4
/ Rood (rip	MrSparkles	LONGEST MAP EVER - Trials Fusion w_ Nick.mp4
mountain misl	MrSparkles	LOW GRAVITY - Trials Fusion w_ Nick.mp4
Moon's crash course	MrSparkles	LOW GRAVITY - Trials Fusion w_ Nick.mp4
K trial	MrSparkles	LOW GRAVITY - Trials Fusion w_ Nick.mp4
I N 1 L8 Night Life	MrSparkles	LOW GRAVITY - Trials Fusion w_ Nick.mp4
The Wasteland	MrNFEN	MAGIC CARPET RIDE - Trials Fusion w_ Nick.mp4
Panda's Journey	MrNFEN	MAGIC CARPET RIDE - Trials Fusion w_ Nick.mp4
TRIALS UP n' UP	MrNFEN	MAGIC CARPET RIDE - Trials Fusion w_ Nick.mp4
/ Sunny day	MrSparkles	MAGIC CARPET RIDE - Trials Fusion w_ Nick.mp4
UKr Solar Power Point	MrSparkles	MAGIKARP - Trials Fusion w_ Nick.mp4
ICE CREAMuArvu	MrNFEN	MAGIKARP - Trials Fusion w_ Nick.mp4
HOW DEEP [5 THE OCEAN +	MrNFEN	MAGIKARP - Trials Fusion w_ Nick.mp4
HYPNOTIZE	MrNFEN	MAGIKARP - Trials Fusion w_ Nick.mp4
Offshore	MrNFEN	MAGIKARP - Trials Fusion w_ Nick.mp4
Progressive Rock (re-up)	MrSparkles	MAKING ISTORY - Trials Fusion w_ Nick.mp4
NILE-Dog Fight	MrNFEN	MAKING ISTORY - Trials Fusion w_ Nick.mp4
[17] Concrele n‘ Ramps 2	MrNFEN	MAKING ISTORY - Trials Fusion w_ Nick.mp4
Aelicn Online	MrSparkles	MAKING ISTORY - Trials Fusion w_ Nick.mp4
Skysaaper Showdown	MrNFEN	MAN VS CHILD - Trials Fusion w_ Nick.mp4
Marina Mania	MrNFEN	MAN VS CHILD - Trials Fusion w_ Nick.mp4
Sformlrooper	MrSparkles	MAN VS CHILD - Trials Fusion w_ Nick.mp4
X-Supercross FINAL RESULTS	MrSparkles	MAN VS CHILD - Trials Fusion w_ Nick.mp4
Bungo‘ow Beach	MrSparkles	MAN VS CHILD - Trials Fusion w_ Nick.mp4
MBS‘TWICE	MrSparkles	MEN IN BLACK - Trials Fusion w_ Nick.mp4
I Am Viper	MrSparkles	MEN IN BLACK - Trials Fusion w_ Nick.mp4
Rol In Pieces	MrSparkles	MEN IN BLACK - Trials Fusion w_ Nick.mp4
Raise The Roof	MrNFEN	MEN IN BLACK - Trials Fusion w_ Nick.mp4
Through the dessert	MrSparkles	MISTAKES WERE MADE - Trials Fusion w_ Nick.mp4
descenso an sueﬁos	MrSparkles	MISTAKES WERE MADE - Trials Fusion w_ Nick.mp4
Downward Spiral	MrNFEN	MISTAKES WERE MADE - Trials Fusion w_ Nick.mp4
graverunner	MrSparkles	MISTAKES WERE MADE - Trials Fusion w_ Nick.mp4
"Temperameuml"	MrSparkles	NECK AND NECK - Trials Fusion w_ Neck.mp4
Desert Cous'er	MrNFEN	NECK AND NECK - Trials Fusion w_ Neck.mp4
Poisoned Tranquility	MrNFEN	NECK AND NECK - Trials Fusion w_ Neck.mp4
Reach For me sky[RE]	MrSparkles	NECK AND NECK - Trials Fusion w_ Neck.mp4
X-Supercross FINAL RESULTS	MrSparkles	NECK AND NECK - Trials Fusion w_ Neck.mp4
Shadows	MrNFEN	NEVER SEEN THAT BEFORE - Trials Fusion w_ Nick.mp4
snowmobile hillclimb	MrNFEN	NEVER SEEN THAT BEFORE - Trials Fusion w_ Nick.mp4
Emsiofu	MrNFEN	NEVER SEEN THAT BEFORE - Trials Fusion w_ Nick.mp4
Black Canvas	MrNFEN	NEVER SEEN THAT BEFORE - Trials Fusion w_ Nick.mp4
A<51 Top Secret	MrNFEN	NEW DNF RECORD - Trials Fusion w_ Nick.mp4
full yoy	MrSparkles	NEW DNF RECORD - Trials Fusion w_ Nick.mp4
Pure	MrNFEN	NEW DNF RECORD - Trials Fusion w_ Nick.mp4
Sunset bridge	MrSparkles	NEW DNF RECORD - Trials Fusion w_ Nick.mp4
Nice And Normal	MrNFEN	NICE & NORMAL - Trials Fusion w_ Nick.mp4
BLUE SECTOR	MrSparkles	NICE & NORMAL - Trials Fusion w_ Nick.mp4
[eIC] Nighllife	MrSparkles	NICE & NORMAL - Trials Fusion w_ Nick.mp4
STELLA	MrNFEN	NINTENDO SWITCHBACK - Trials Fusion w_ Nick.mp4
Le Slade	MrSparkles	NINTENDO SWITCHBACK - Trials Fusion w_ Nick.mp4
" Wasteland	MrSparkles	NINTENDO SWITCHBACK - Trials Fusion w_ Nick.mp4
N 1 LB-Enchunled Romance	MrNFEN	NOPE THAT'S NOT GONNA HAPPEN - Trials Fusion w_ Nick.mp4
csfulro	MrSparkles	NOPE THAT'S NOT GONNA HAPPEN - Trials Fusion w_ Nick.mp4
B.I,K.E Dynamics Lab 3	MrNFEN	NOPE THAT'S NOT GONNA HAPPEN - Trials Fusion w_ Nick.mp4
Air Truck	MrNFEN	NOTHING AT ALL - Trials Fusion w_ Nick.mp4
Firsf Track :)	MrNFEN	NOTHING AT ALL - Trials Fusion w_ Nick.mp4
asfulv 6. ramps	MrNFEN	NOTHING AT ALL - Trials Fusion w_ Nick.mp4
The daaih world pl 1	MrNFEN	NOTHING AT ALL - Trials Fusion w_ Nick.mp4
Suwoonders	MrSparkles	NUKED - Trials Fusion w_ Nick.mp4
Riding on water	MrNFEN	NUKED - Trials Fusion w_ Nick.mp4
Red World	MrSparkles	NUKED - Trials Fusion w_ Nick.mp4
Roach hard	MrNFEN	NUKED - Trials Fusion w_ Nick.mp4
Series 0‘ Tubes	MrSparkles	ON A ROLL - Trials Fusion w_ Nick.mp4
Icebreaker	MrSparkles	ON A ROLL - Trials Fusion w_ Nick.mp4
Cold Storage	MrSparkles	ON A ROLL - Trials Fusion w_ Nick.mp4
Expedilion	MrSparkles	ON A ROLL - Trials Fusion w_ Nick.mp4
ArdiL Chi‘ls	MrSparkles	ONE WHEEL ONLY - Trials Fusion w_ Nick.mp4
Desert Trials Ride	MrNFEN	ONE WHEEL ONLY - Trials Fusion w_ Nick.mp4
10 LEVEL!	MrSparkles	ONE WHEEL ONLY - Trials Fusion w_ Nick.mp4
My sacral hideoul ++	MrSparkles	ONE WHEEL ONLY - Trials Fusion w_ Nick.mp4
El Gringo	MrNFEN	PANDA BOYS - Trials Fusion w_ Nick.mp4
V Cold Peck	MrNFEN	PANDA BOYS - Trials Fusion w_ Nick.mp4
Unusml Construurtion	MrSparkles	PANDA BOYS - Trials Fusion w_ Nick.mp4
Troublelown	MrSparkles	PANDA BOYS - Trials Fusion w_ Nick.mp4
X-Supercross FINAL RESULTS	MrNFEN	PANDA BOYS - Trials Fusion w_ Nick.mp4
Aﬁermath Loop	MrNFEN	PANDA FAIL - Trials Fusion w_ Nick.mp4
Valley of lhe Tilun	MrNFEN	PANDA FAIL - Trials Fusion w_ Nick.mp4
Gardens Grove	MrNFEN	PANDA FAIL - Trials Fusion w_ Nick.mp4
Hof Crater	MrSparkles	PINEAPPLE ON PIZZA - Trials Fusion w_ Nick.mp4
Facility Shuldown	MrNFEN	PINEAPPLE ON PIZZA - Trials Fusion w_ Nick.mp4
Rocks n Trucks	MrSparkles	PINEAPPLE ON PIZZA - Trials Fusion w_ Nick.mp4
Chi|dren‘s Game (new!)	MrSparkles	PINK SLIPS - Trials Fusion w_ Nick.mp4
Arctic Falls	MrSparkles	PINK SLIPS - Trials Fusion w_ Nick.mp4
Razors Edge	MrSparkles	PINK SLIPS - Trials Fusion w_ Nick.mp4
Desert Desser?	MrNFEN	PINK SLIPS - Trials Fusion w_ Nick.mp4
Deep sea industry	MrSparkles	PLAYER 3 HAS ENTERED - Trials Fusion w_ Mark & Nick.mp4
High Sociaiy GoPro	Player YYFakieDualCom winsl	PLAYER 3 HAS ENTERED - Trials Fusion w_ Mark & Nick.mp4
[DD] Lost Siop	Player YYFakieDualCom wins!	PLAYER 3 HAS ENTERED - Trials Fusion w_ Mark & Nick.mp4
CUbe cube 1	MrSparkles	PLAYER 3 HAS ENTERED - Trials Fusion w_ Mark & Nick.mp4
N 1 LE-Chasing Mr. Kringle	MrNFEN	PLUNDERING CHRISTMAS - Trials Fusion w_ Nick.mp4
\' Red Cactus	MrNFEN	PLUNDERING CHRISTMAS - Trials Fusion w_ Nick.mp4
Condemned.	MrSparkles	PLUNDERING CHRISTMAS - Trials Fusion w_ Nick.mp4
{i1}. Donkay Doodle Darby Tlma	MrNFEN	PRESIDENT OF THE UNITED STEEZ - Trials Fusion w_ Nick.mp4
Purple & Pain	MrSparkles	PRESIDENT OF THE UNITED STEEZ - Trials Fusion w_ Nick.mp4
‘ / Complexx	MrSparkles	PRESIDENT OF THE UNITED STEEZ - Trials Fusion w_ Nick.mp4
Frozen boy	MrSparkles	PRESIDENT OF THE UNITED STEEZ - Trials Fusion w_ Nick.mp4
/Runuwuy Unicorn	MrNFEN	PROFESSIONAL TRIALS LEAGUE - Trials Fusion w_ Nick.mp4
Pony Ride	MrNFEN	PROFESSIONAL TRIALS LEAGUE - Trials Fusion w_ Nick.mp4
not guilty (ﬁxed and)	MrNFEN	PROFESSIONAL TRIALS LEAGUE - Trials Fusion w_ Nick.mp4
viper downhill SPEED RUN	MrNFEN	PURPLE NURPLE - Trials Fusion w_ Nick.mp4
Timber	MrSparkles	PURPLE NURPLE - Trials Fusion w_ Nick.mp4
Purple nurple	MrSparkles	PURPLE NURPLE - Trials Fusion w_ Nick.mp4
Out of time Ml	MrNFEN	PURPLE NURPLE - Trials Fusion w_ Nick.mp4
Destinuﬁon our ++1	MrSparkles	PURPLE NURPLE - Trials Fusion w_ Nick.mp4
Tonpellier	MrNFEN	Please Don't Watch This Nick Made Me Post It - Trials Fusion w_ Nick.mp4
* ’ The City Derby 7.4	MrNFEN	Please Don't Watch This Nick Made Me Post It - Trials Fusion w_ Nick.mp4
I ll 11]]	MrSparkles	Please Don't Watch This Nick Made Me Post It - Trials Fusion w_ Nick.mp4
K 1 5! Truck	MrSparkles	RABBIT MISTAKE - Trials Fusion w_ Nick.mp4
~Snow Crack"	MrNFEN	RABBIT MISTAKE - Trials Fusion w_ Nick.mp4
Toward The CanOer(Ep3)	MrSparkles	RABBIT MISTAKE - Trials Fusion w_ Nick.mp4
Redlynx Luwsuil	MrSparkles	RABBIT MISTAKE - Trials Fusion w_ Nick.mp4
DTC 2	MrNFEN	RACE TO THE BOTTOM - Trials Fusion w_ Nick.mp4
Slicks arctic	MrSparkles	RACE TO THE BOTTOM - Trials Fusion w_ Nick.mp4
Race to lhe Bottom	MrSparkles	RACE TO THE BOTTOM - Trials Fusion w_ Nick.mp4
roach ruins	MrSparkles	RACE TO THE BOTTOM - Trials Fusion w_ Nick.mp4
Syn SladEUm 2065	MrSparkles	RAGE QUIT - Trials Fusion w_ Nick.mp4
omposr	MrSparkles	RAGE QUIT - Trials Fusion w_ Nick.mp4
Crevusse	MrSparkles	RAGE QUIT - Trials Fusion w_ Nick.mp4
Jurassic Dig	MrSparkles	RAGE QUIT - Trials Fusion w_ Nick.mp4
Moon	MrSparkles	READY FOR TAKEOFF - Trials Fusion w_ Nick.mp4
Logging Country	MrSparkles	READY FOR TAKEOFF - Trials Fusion w_ Nick.mp4
TFG-ROAD	MrNFEN	READY FOR TAKEOFF - Trials Fusion w_ Nick.mp4
TITAN	MrNFEN	READY FOR TAKEOFF - Trials Fusion w_ Nick.mp4
Melal All Bikes	MrSparkles	RETURN OF THE DONK - Trials Fusion w_ Nick.mp4
Piece of Mind	MrNFEN	RETURN OF THE DONK - Trials Fusion w_ Nick.mp4
Scorpio Land	MrSparkles	RETURN OF THE DONK - Trials Fusion w_ Nick.mp4
/' X-Supercross FINAL RESULTS	MrNFEN	RETURN OF THE DONK - Trials Fusion w_ Nick.mp4
Cold Embrace	MrSparkles	RETURN OF THE PANDA BOYS - Trials Fusion w_ Nick.mp4
Old Rock	MrSparkles	RETURN OF THE PANDA BOYS - Trials Fusion w_ Nick.mp4
Compagne	MrSparkles	RETURN OF THE PANDA BOYS - Trials Fusion w_ Nick.mp4
=V= Prehep	MrNFEN	RIDING ON WATER - Trials Fusion w_ Nick.mp4
The Woler Sprint	MrNFEN	RIDING ON WATER - Trials Fusion w_ Nick.mp4
BMX Resort hard	MrSparkles	RIDING ON WATER - Trials Fusion w_ Nick.mp4
2’ Random Obstacles,“	MrSparkles	RIDING ON WATER - Trials Fusion w_ Nick.mp4
Lets 90	MrNFEN	RIP DONKEY - Trials Fusion w_ Nick.mp4
Pdsolidsfeel	MrSparkles	RIP DONKEY - Trials Fusion w_ Nick.mp4
/ its all up hill ,.,.T 6	MrNFEN	RIP DONKEY - Trials Fusion w_ Nick.mp4
Across 2 sea 74	MrSparkles	RIP DONKEY - Trials Fusion w_ Nick.mp4
InToTheJUngle	MrSparkles	RIP YOUTUBE - Trials Fusion w_ Nick.mp4
misty run,	MrSparkles	RIP YOUTUBE - Trials Fusion w_ Nick.mp4
The Lazy Solurday n	MrSparkles	RIP YOUTUBE - Trials Fusion w_ Nick.mp4
The North Face	MrNFEN	RIP YOUTUBE - Trials Fusion w_ Nick.mp4
0remp|in	MrSparkles	SANDWICH WARS - Trials Fusion w_ Nick.mp4
THE FACILITY	MrSparkles	SANDWICH WARS - Trials Fusion w_ Nick.mp4
Mauritius cl Night	MrSparkles	SANDWICH WARS - Trials Fusion w_ Nick.mp4
Timber Tantrum	MrSparkles	SECRET AGENT - Trials Fusion w_ Nick.mp4
‘1’ NEON KNIGHTSH‘I	MrSparkles	SECRET AGENT - Trials Fusion w_ Nick.mp4
Does This Game Work?	MrNFEN	SECRET AGENT - Trials Fusion w_ Nick.mp4
slopwastingserverspoce	MrSparkles	SECRET AGENT - Trials Fusion w_ Nick.mp4
.Piluve-	MrNFEN	SECRET AGENT - Trials Fusion w_ Nick.mp4
Empire of the sky	MrSparkles	SELF-INFLICTED WOUND  - Trials Fusion w_ Nick.mp4
:‘ comm Eagle	MrNFEN	SELF-INFLICTED WOUND  - Trials Fusion w_ Nick.mp4
CSS Beach	MrSparkles	SELF-INFLICTED WOUND  - Trials Fusion w_ Nick.mp4
CITY LIFE 2.!	MrSparkles	SEVEN MAP MARATHON - Trials Fusion w_ Nick.mp4
The Rodrigo Run?	MrNFEN	SEVEN MAP MARATHON - Trials Fusion w_ Nick.mp4
SPEEDRUN #2	MrSparkles	SEVEN MAP MARATHON - Trials Fusion w_ Nick.mp4
Askillbag	MrSparkles	SEVEN MAP MARATHON - Trials Fusion w_ Nick.mp4
Dari Woods	MrNFEN	SEVEN MAP MARATHON - Trials Fusion w_ Nick.mp4
Stone gather	MrSparkles	SEVEN MAP MARATHON - Trials Fusion w_ Nick.mp4
SamIron	MrSparkles	SEVEN MAP MARATHON - Trials Fusion w_ Nick.mp4
Viper&Rouch SPEED RUN	MrNFEN	SICK BUGATTI BRO - Trials Fusion w_ Nick.mp4
ofﬁce escape	MrSparkles	SICK BUGATTI BRO - Trials Fusion w_ Nick.mp4
[[ARTIC ISLAND PIT VIPER	MrSparkles	SICK BUGATTI BRO - Trials Fusion w_ Nick.mp4
P the bridge of death	MrNFEN	SICK BUGATTI BRO - Trials Fusion w_ Nick.mp4
New rider IBUKING Roach	MrNFEN	SLOMO - Trials Fusion w_ Nick.mp4
.. V Up'n Down Speed-Hill	MrSparkles	SLOMO - Trials Fusion w_ Nick.mp4
Arctic‘Wheelie	MrNFEN	SLOMO - Trials Fusion w_ Nick.mp4
My Truck 2	MrNFEN	SLOMO - Trials Fusion w_ Nick.mp4
SoniraZOOO	MrSparkles	SON OF THE SUN - Trials Fusion w_ Nick.mp4
Sunny Day Real Eslote	MrNFEN	SON OF THE SUN - Trials Fusion w_ Nick.mp4
Stride of Abhorrence	MrSparkles	SON OF THE SUN - Trials Fusion w_ Nick.mp4
Jungle Isle	MrNFEN	SON OF THE SUN - Trials Fusion w_ Nick.mp4
The BIG one	MrSparkles	STEEZ IS KEY - Trials Fusion w_ Nick.mp4
White	MrSparkles	STEEZ IS KEY - Trials Fusion w_ Nick.mp4
Shadow of Dunbv [Hard]	MrSparkles	STEEZ IS KEY - Trials Fusion w_ Nick.mp4
Viper almost extreme 6	MrNFEN	STEEZ IS KEY - Trials Fusion w_ Nick.mp4
25 deeds	MrSparkles	STEEZ ME UP - Trials Fusion w_ Nick.mp4
Welcome back From wheel	MrSparkles	STEEZ ME UP - Trials Fusion w_ Nick.mp4
Bunny Hop Nighlmure.	MrSparkles	STEEZ ME UP - Trials Fusion w_ Nick.mp4
"' Crazy DOWnHm '"	MrSparkles	STEEZ ME UP - Trials Fusion w_ Nick.mp4
he! weels	MrNFEN	STEEZ ME UP - Trials Fusion w_ Nick.mp4
ATVIIALIEN ABDUCIION	MrNFEN	STEEZLORD - Trials Fusion w_ Nick.mp4
TurboTricl Romes	MrSparkles	STEEZLORD - Trials Fusion w_ Nick.mp4
Triangle & box	MrNFEN	STEEZLORD - Trials Fusion w_ Nick.mp4
Iriols porkor port 7	MrNFEN	STEEZY 350 - Trials Fusion w_ Nick.mp4
ED 209 [SP1NALFLU1D]	MrSparkles	STEEZY 350 - Trials Fusion w_ Nick.mp4
Pink	MrSparkles	STEEZY 350 - Trials Fusion w_ Nick.mp4
Donkey, me Jumper.	MrSparkles	STEEZY 350 - Trials Fusion w_ Nick.mp4
Indoor Trials	MrNFEN	STRUGGLING - Trials Fusion w_ Nick.mp4
Snowmons Land	MrNFEN	STRUGGLING - Trials Fusion w_ Nick.mp4
Diurrhé ﬁir Anfﬁnger	MrSparkles	STRUGGLING - Trials Fusion w_ Nick.mp4
BOT,cinHardV	MrNFEN	STRUGGLING - Trials Fusion w_ Nick.mp4
Black And White	MrSparkles	SUBZ N VIEWS - Trials Fusion w_ Nick.mp4
Small imposible stairs	MrSparkles	SUBZ N VIEWS - Trials Fusion w_ Nick.mp4
Rainbow Road	MrSparkles	SUBZ N VIEWS - Trials Fusion w_ Nick.mp4
HIGH SPEED PANDA	MrNFEN	SUPER FAST FERRARI - Trials Fusion w_ Nick.mp4
0' The green and red TITO	MrNFEN	SUPER FAST FERRARI - Trials Fusion w_ Nick.mp4
GET OFF MY ROOF!!!	MrNFEN	SUPER FAST FERRARI - Trials Fusion w_ Nick.mp4
Monmin Puvh (Fix)	Player Mr$park|yPants wins!	SUPER FAST FERRARI - Trials Fusion w_ Nick.mp4
HIGH NATURE	MrSparkles	SUPER FAST FERRARI - Trials Fusion w_ Nick.mp4
‘Cube‘	MrSparkles	SUSHI DIET - Trials Fusion w_ Nick.mp4
Snow uir!	MrNFEN	SUSHI DIET - Trials Fusion w_ Nick.mp4
Caclus desert skill	MrSparkles	SUSHI DIET - Trials Fusion w_ Nick.mp4
/Coclus river Climb	MrNFEN	SUSHI DIET - Trials Fusion w_ Nick.mp4
Artic Advelure	MrSparkles	TANUKI SUIT- Trials Fusion w_ Nick.mp4
Viper River-Run	MrNFEN	TANUKI SUIT- Trials Fusion w_ Nick.mp4
Three Boa! Challenge	MrNFEN	TANUKI SUIT- Trials Fusion w_ Nick.mp4
TANUKI FACI'ORY	MrNFEN	TANUKI SUIT- Trials Fusion w_ Nick.mp4
9 Rock Volcano	MrNFEN	TECH DECKS - Trials Fusion w_ Nick.mp4
um: MOUNT SHROOM mm	MrSparkles	TECH DECKS - Trials Fusion w_ Nick.mp4
IHF‘JSQ)’ Rockl ll	MrSparkles	TECH DECKS - Trials Fusion w_ Nick.mp4
A bit of it all	MrSparkles	TECH DECKS - Trials Fusion w_ Nick.mp4
X-Supercross FINAL RESULTS	MrSparkles	TECH DECKS - Trials Fusion w_ Nick.mp4
old ruins	MrSparkles	THAT WAS A PAIN - Trials Fusion w_ Nick.mp4
hippo	MrSparkles	THAT WAS A PAIN - Trials Fusion w_ Nick.mp4
Rocky Resorts	MrNFEN	THAT WAS A PAIN - Trials Fusion w_ Nick.mp4
Forgenan Pipeline 7-D F	MrSparkles	THAT WAS A PAIN - Trials Fusion w_ Nick.mp4
X-Supercross FINAL RESULTS	MrSparkles	THAT WAS A PAIN - Trials Fusion w_ Nick.mp4
For SAM & LOGAN	MrSparkles	THAT'S HOW WE'RE TALKING ABOUT - Trials Fusion w_ Nick.mp4
Awn99 SECONDsu	MrSparkles	THAT'S HOW WE'RE TALKING ABOUT - Trials Fusion w_ Nick.mp4
Solitude	MrNFEN	THAT'S HOW WE'RE TALKING ABOUT - Trials Fusion w_ Nick.mp4
Sfoney	MrNFEN	THAT'S HOW WE'RE TALKING ABOUT - Trials Fusion w_ Nick.mp4
The Old Enduro Track	MrSparkles	THE CLOSEST FINISH OF ALL TIME - Trials Fusion w_ Nick.mp4
While Concrete	MrSparkles	THE CLOSEST FINISH OF ALL TIME - Trials Fusion w_ Nick.mp4
Return of the Block	MrNFEN	THE CLOSEST FINISH OF ALL TIME - Trials Fusion w_ Nick.mp4
Northern Light	MrNFEN	THE CLOSEST FINISH OF ALL TIME - Trials Fusion w_ Nick.mp4
X-Supercross FINAL RESULTS	MrNFEN	THE CLOSEST FINISH OF ALL TIME - Trials Fusion w_ Nick.mp4
Airpon Madness	MrSparkles	THE CLOSEST GAME OF ALL TIME - Trials Fusion w_ Nick.mp4
/‘ My Treasure	MrNFEN	THE CLOSEST GAME OF ALL TIME - Trials Fusion w_ Nick.mp4
7 / Tutsuyo Pork	MrNFEN	THE CLOSEST GAME OF ALL TIME - Trials Fusion w_ Nick.mp4
Wild climb	MrNFEN	THE CLOSEST GAME OF ALL TIME - Trials Fusion w_ Nick.mp4
g Around the Oasis	MrNFEN	THE COMEBACK - Trials Fusion w_ Nick.mp4
Temple Trouble	MrNFEN	THE COMEBACK - Trials Fusion w_ Nick.mp4
Eco Pork	MrSparkles	THE COMEBACK - Trials Fusion w_ Nick.mp4
Rocky Road	MrSparkles	THE COMEBACK - Trials Fusion w_ Nick.mp4
X’supercross HNAL RESULTS	MrSparkles	THE COMEBACK - Trials Fusion w_ Nick.mp4
Volcano Clifvaun	MrSparkles	THE DECLARATION - Trials Fusion w_ Nick.mp4
Rocky Mun TucA	MrSparkles	THE DECLARATION - Trials Fusion w_ Nick.mp4
Meet Lulu	MrSparkles	THE DECLARATION - Trials Fusion w_ Nick.mp4
Around "‘3 Coast	MrNFEN	THE DECLARATION - Trials Fusion w_ Nick.mp4
Swamp Crash	MrSparkles	THE DONK - Trials Fusion w_ Nick.mp4
' ‘ Around the Oasis	MrSparkles	THE DONK - Trials Fusion w_ Nick.mp4
Tampla Trauma	MrNFEN	THE DONK - Trials Fusion w_ Nick.mp4
X-Supercross FINAL RESULTS	MrSparkles	THE DONK - Trials Fusion w_ Nick.mp4
X-Supercross FINAL RESULTS	MrSparkles	THE DONK - Trials Fusion w_ Nick.mp4
PIRAMYD	MrNFEN	THE DONK STRIKES BACK - Trials Fusion w_ Nick.mp4
[Zr] Abstracted -med	Player Mr$parklyPants wins!	THE DONK STRIKES BACK - Trials Fusion w_ Nick.mp4
[zr] Abstracved -hard	MrSparkles	THE DONK STRIKES BACK - Trials Fusion w_ Nick.mp4
Founded	MrSparkles	THE DONK STRIKES BACK - Trials Fusion w_ Nick.mp4
X-Supercross FINAL RESULTS	MrSparkles	THE DONK STRIKES BACK - Trials Fusion w_ Nick.mp4
Misty Luke	MrNFEN	THE DONKEY RETURNS - Trials Fusion w_ Nick.mp4
Aokigahura	MrNFEN	THE DONKEY RETURNS - Trials Fusion w_ Nick.mp4
MPC Dirulo	MrSparkles	THE DONKEY RETURNS - Trials Fusion w_ Nick.mp4
X-Supercross FINAL RESULTS	MrSparkles	THE DONKEY RETURNS - Trials Fusion w_ Nick.mp4
DVE TRATE 2	MrSparkles	THE DONKEY RETURNS - Trials Fusion w_ Nick.mp4
~UndergrounD~	MrSparkles	THE DOWNFALL - Trials Fusion w_ Nick.mp4
"cosmopolis"	MrSparkles	THE DOWNFALL - Trials Fusion w_ Nick.mp4
Zero	MrSparkles	THE DOWNFALL - Trials Fusion w_ Nick.mp4
Rubble	MrSparkles	THE DOWNFALL - Trials Fusion w_ Nick.mp4
FWM's Track N No!	MrSparkles	THE FLOOR IS FALLING  - Trials Fusion w_ Nick.mp4
NI [8 Natural Hill Climb	MrSparkles	THE FLOOR IS FALLING  - Trials Fusion w_ Nick.mp4
Wooden Structures 20	MrNFEN	THE FLOOR IS FALLING  - Trials Fusion w_ Nick.mp4
Viper barrels	MrSparkles	THE FLOOR IS FALLING  - Trials Fusion w_ Nick.mp4
Juxe	MrSparkles	THE GAME IS RIGGED - Trials Fusion w_ Nick.mp4
Cur landing	MrSparkles	THE GAME IS RIGGED - Trials Fusion w_ Nick.mp4
Beachpcrry shorlcm	MrNFEN	THE GAME IS RIGGED - Trials Fusion w_ Nick.mp4
Viper ruin	MrNFEN	THE GAME IS RIGGED - Trials Fusion w_ Nick.mp4
Covert Ops	MrNFEN	THE GLITCH - Trials Fusion w_ Nick.mp4
Shorvcm	MrSparkles	THE GLITCH - Trials Fusion w_ Nick.mp4
. Digger	MrSparkles	THE GLITCH - Trials Fusion w_ Nick.mp4
The Hangout	MrSparkles	THE GLITCH - Trials Fusion w_ Nick.mp4
Dream Jump	MrSparkles	THE GREATEST COMEBACK STORY - Trials Fusion w_ Nick.mp4
Trials HD- Underwater	MrNFEN	THE GREATEST COMEBACK STORY - Trials Fusion w_ Nick.mp4
Glaw Warm -[SR]~	MrNFEN	THE GREATEST COMEBACK STORY - Trials Fusion w_ Nick.mp4
[UKR] ROCKAMANIA...	MrSparkles	THE GREATEST COMEBACK STORY - Trials Fusion w_ Nick.mp4
No Gas Observatory	MrNFEN	THE HARDEST MAP EVER - Trials Fusion w_ Nick.mp4
You is it dead 2	MrNFEN	THE HARDEST MAP EVER - Trials Fusion w_ Nick.mp4
N1 L8 Warp Zone	MrSparkles	THE HARDEST MAP EVER - Trials Fusion w_ Nick.mp4
ML Silver Springs	MrSparkles	THE HARDEST MAP EVER - Trials Fusion w_ Nick.mp4
I can‘t gels snow sleep!	MrSparkles	THE IMPOSSIBLE MAP - Trials Fusion w_ Nick.mp4
Iceland	MrSparkles	THE IMPOSSIBLE MAP - Trials Fusion w_ Nick.mp4
ruin hard	MrNFEN	THE IMPOSSIBLE MAP - Trials Fusion w_ Nick.mp4
RABBIT series [rock 2	MrNFEN	THE IMPOSSIBLE MAP - Trials Fusion w_ Nick.mp4
"Switches Desert (2Dl'	MrSparkles	THE JAR JAR CURSE - Trials Fusion w_ Nick.mp4
"Macho-Fusion"	MrNFEN	THE JAR JAR CURSE - Trials Fusion w_ Nick.mp4
Climbing the iceberg	MrSparkles	THE JAR JAR CURSE - Trials Fusion w_ Nick.mp4
Mesoomerica	MrSparkles	THE JAR JAR CURSE - Trials Fusion w_ Nick.mp4
SUpernovu SUnse'	MrSparkles	THE PRICE IS RIGHT - Trials Fusion w_ Nick.mp4
Rising Sun	MrSparkles	THE PRICE IS RIGHT - Trials Fusion w_ Nick.mp4
Another box frock	MrSparkles	THE PRICE IS RIGHT - Trials Fusion w_ Nick.mp4
Gui Check	MrNFEN	THE PRICE IS RIGHT - Trials Fusion w_ Nick.mp4
Mare Crisium	MrNFEN	THE RAGE AWAKENS - Trials Fusion w_ Nick.mp4
Shortcut	MrNFEN	THE RAGE AWAKENS - Trials Fusion w_ Nick.mp4
Iss 3000	MrSparkles	THE RAGE AWAKENS - Trials Fusion w_ Nick.mp4
Antarctic:	MrSparkles	THE RAGE AWAKENS - Trials Fusion w_ Nick.mp4
’ Whargoes up.“	MrNFEN	THE REDEMPTION - Trials Fusion w_ Nick.mp4
WTF 2	MrNFEN	THE REDEMPTION - Trials Fusion w_ Nick.mp4
Downfall - Level 2	MrNFEN	THE REDEMPTION - Trials Fusion w_ Nick.mp4
X-Supercross FINAL RESULTS	MrNFEN	THE REDEMPTION - Trials Fusion w_ Nick.mp4
Beat it under 1 minute	MrSparkles	THE REDEMPTION - Trials Fusion w_ Nick.mp4
Doin it baggy style 2	MrNFEN	THE REDEMPTION - Trials Fusion w_ Nick.mp4
RaceWors | |	MrSparkles	THE REDEMPTION - Trials Fusion w_ Nick.mp4
CucIus Sway lo end	MrSparkles	THE REDEMPTION - Trials Fusion w_ Nick.mp4
Green Energy	MrSparkles	THE SPECIALIST - Trials Fusion w_ Nick.mp4
Losl wheel run	MrSparkles	THE SPECIALIST - Trials Fusion w_ Nick.mp4
The Lasl Rider ¥	MrSparkles	THE SPECIALIST - Trials Fusion w_ Nick.mp4
I Am Rabbi!	MrNFEN	THE SPECIALIST - Trials Fusion w_ Nick.mp4
Your Eyes Look Tyred	MrNFEN	THE STEEZIEST MAP EVER - Trials Fusion w_ Nick.mp4
Thronle Therapy EZ	MrSparkles	THE STEEZIEST MAP EVER - Trials Fusion w_ Nick.mp4
Skyrun	MrNFEN	THE STEEZIEST MAP EVER - Trials Fusion w_ Nick.mp4
HOW INSENSITIVE++	MrNFEN	THE STEEZIEST MAP EVER - Trials Fusion w_ Nick.mp4
Minimi V6	MrSparkles	THE STEEZIEST MAP EVER - Trials Fusion w_ Nick.mp4
Don't get love for work!	MrSparkles	THE TRIALS PODCAST - Trials Fusion w_ Nick.mp4
RAGE!!!!!!!!!!!!!!	MrSparkles	THE TRIALS PODCAST - Trials Fusion w_ Nick.mp4
Roche	MrNFEN	THE TRIALS PODCAST - Trials Fusion w_ Nick.mp4
Desert donkey	MrSparkles	THE TRIALS PODCAST - Trials Fusion w_ Nick.mp4
Ride through time	MrSparkles	THE UNICORN HAS ARRIVED - Trials Fusion w_ Mark & Nick.mp4
BLUE ELEMENT VIPER	MrNFEN	THE UNICORN HAS ARRIVED - Trials Fusion w_ Mark & Nick.mp4
MoOunui	MrNFEN	THE UNICORN HAS ARRIVED - Trials Fusion w_ Mark & Nick.mp4
Thistle	Player YYFakieDualCom wins!	THE UNICORN HAS ARRIVED - Trials Fusion w_ Mark & Nick.mp4
Leader Board Aﬂuck (T9)	MrNFEN	THE WORST SOUND EVER - Trials Fusion w_ Nick.mp4
ATv"Agenr 007 Escape"	MrSparkles	THE WORST SOUND EVER - Trials Fusion w_ Nick.mp4
Alien junk-yard	MrSparkles	THE WORST SOUND EVER - Trials Fusion w_ Nick.mp4
RuptureFarms REDUX	MrNFEN	THE WORST SOUND EVER - Trials Fusion w_ Nick.mp4
'No Gas BMX Downhill	MrNFEN	THIS IS ALL SCRIPTED - Trials Fusion w_ Nick.mp4
Donkey Rot WeiB	MrSparkles	THIS IS ALL SCRIPTED - Trials Fusion w_ Nick.mp4
Viper long disVance	MrNFEN	THIS IS ALL SCRIPTED - Trials Fusion w_ Nick.mp4
\: /GOT woor>\:/	MrNFEN	THIS IS ALL SCRIPTED - Trials Fusion w_ Nick.mp4
Nine Rocks #4	MrSparkles	THREE HARDS - Trials Fusion w_ Nick.mp4
The Flippity Flop 2	MrSparkles	THREE HARDS - Trials Fusion w_ Nick.mp4
(:55 Lost Jungle	MrSparkles	THREE HARDS - Trials Fusion w_ Nick.mp4
In the Flaw	MrSparkles	THREE HARDS - Trials Fusion w_ Nick.mp4
[[NIGHT SPEED RABBITll	MrSparkles	THREE HARDS - Trials Fusion w_ Nick.mp4
In Parcdisum	MrNFEN	THROWN FOR A LOOP - Trials Fusion w_ Nick.mp4
Wipeour	MrSparkles	THROWN FOR A LOOP - Trials Fusion w_ Nick.mp4
Control Freak	MrSparkles	THROWN FOR A LOOP - Trials Fusion w_ Nick.mp4
Tired Nigho Way	MrSparkles	THROWN FOR A LOOP - Trials Fusion w_ Nick.mp4
X-Supercross FINAL RESULTS	MrSparkles	THROWN FOR A LOOP - Trials Fusion w_ Nick.mp4
A Trad In The Sky	MrSparkles	TIEBREAKER - Trials Fusion w_ Nick.mp4
What I do u! The Airport	MrNFEN	TIEBREAKER - Trials Fusion w_ Nick.mp4
Platinum zhullenge #1	MrSparkles	TIEBREAKER - Trials Fusion w_ Nick.mp4
Vipercousrer	MrSparkles	TIEBREAKER - Trials Fusion w_ Nick.mp4
/ Jungle Gymkhana	MrSparkles	TOO EXTREME - Trials Fusion w_ Nick.mp4
RedLynx Derby	MrSparkles	TOO EXTREME - Trials Fusion w_ Nick.mp4
Light City Run	MrSparkles	TOO EXTREME - Trials Fusion w_ Nick.mp4
Burrow Hill (2)	MrSparkles	TOTALLY RADICAL BRAH - Trials Fusion w_ Nick.mp4
Hellacious	MrNFEN	TOTALLY RADICAL BRAH - Trials Fusion w_ Nick.mp4
[RLTA] elCamsterino	MrSparkles	TOTALLY RADICAL BRAH - Trials Fusion w_ Nick.mp4
Afternoon	MrSparkles	TOTALLY RADICAL BRAH - Trials Fusion w_ Nick.mp4
cliff iump	MrNFEN	TRASH TALK - Trials Fusion w_ Mark & Nick.mp4
imalacouol poverty.“	MrSparkles	TRASH TALK - Trials Fusion w_ Mark & Nick.mp4
VNV Ges.mbH	MrNFEN	TRASH TALK - Trials Fusion w_ Mark & Nick.mp4
its all a bi! rocky	Player YYFakieDualCom wins!	TRASH TALK - Trials Fusion w_ Mark & Nick.mp4
3 Worlds ATV-Tour	MrSparkles	TRIALS FUSION #100 SPECIAL.mp4
Good Slide 2 0	MrSparkles	TRIALS FUSION #100 SPECIAL.mp4
Ride In The Dark	MrSparkles	TRIALS FUSION #100 SPECIAL.mp4
Mygery No More )	MrNFEN	TRIALS FUSION #100 SPECIAL.mp4
Demo #1	MrSparkles	TRIALS FUSION #100 SPECIAL.mp4
Relern lo ghetto #	MrSparkles	TRIALS FUSION #100 SPECIAL.mp4
Mar de diﬁcil die noche	MrSparkles	TRIALS FUSION #100 SPECIAL.mp4
The Wooden Donkey	MrNFEN	TRIALS FUSION #100 SPECIAL.mp4
'No Gas BMX Downhill #2	MrSparkles	TRIALSIEST - Trials Fusion w_ Nick.mp4
Floory	MrNFEN	TRIALSIEST - Trials Fusion w_ Nick.mp4
the orOi:	MrSparkles	TRIALSIEST - Trials Fusion w_ Nick.mp4
/ TRIAL CHAMPIONSHIP 2016	MrSparkles	TRIALSIEST - Trials Fusion w_ Nick.mp4
KB' Minimu‘ Effort	MrSparkles	TRIALSMAN V SUPERMAN - Trials Fusion w_ Nick.mp4
2“ 7-2	MrNFEN	TRIALSMAN V SUPERMAN - Trials Fusion w_ Nick.mp4
/ Plastic Beach	MrSparkles	TRIALSMAN V SUPERMAN - Trials Fusion w_ Nick.mp4
Y59\Pure obslucle/	MrSparkles	TRIALSMAN V SUPERMAN - Trials Fusion w_ Nick.mp4
/:lersus Mode]	MrNFEN	TRIALSMAN V SUPERMAN - Trials Fusion w_ Nick.mp4
Urban Decay	MrSparkles	UNEXPECTED VICTORY - Trials Fusion w_ Mark & Nick.mp4
Desert Ramps	MrNFEN	UNEXPECTED VICTORY - Trials Fusion w_ Mark & Nick.mp4
The Workshops	Player YYFakieDualCom wins!	UNEXPECTED VICTORY - Trials Fusion w_ Mark & Nick.mp4
iump hop skip”	/ Player YYFa IeDua|Con1 wins!	UNEXPECTED VICTORY - Trials Fusion w_ Mark & Nick.mp4
SUPER TANUKI EASY	MrNFEN	UNFORTUNATE EVENTS - Trials Fusion w_ Nick.mp4
Lil' Boat Trip	MrNFEN	UNFORTUNATE EVENTS - Trials Fusion w_ Nick.mp4
[JP—hm run	MrNFEN	UNFORTUNATE EVENTS - Trials Fusion w_ Nick.mp4
A ROCKV NIGHT	MrNFEN	UNITED FRONT - Trials Fusion w_ Nick.mp4
f Big Air Speedmunda	MrSparkles	UNITED FRONT - Trials Fusion w_ Nick.mp4
"""T'Iredness	MrNFEN	UNITED FRONT - Trials Fusion w_ Nick.mp4
CP 1 Woodworks	MrNFEN	UNITED FRONT - Trials Fusion w_ Nick.mp4
/ Jungle dunkle	MrSparkles	UNSTEEZABLE - Trials Fusion w_ Nick.mp4
[Vegas] Maitdown	MrSparkles	UNSTEEZABLE - Trials Fusion w_ Nick.mp4
WoodTech	MrSparkles	UNSTEEZABLE - Trials Fusion w_ Nick.mp4
Minimi V6	MrSparkles	UNSTEEZABLE - Trials Fusion w_ Nick.mp4
Cross Counory Jumps	MrNFEN	WE ARE THE FASTEST - Trials Fusion w_ Nick.mp4
.UNDER THE SAND	MrSparkles	WE ARE THE FASTEST - Trials Fusion w_ Nick.mp4
MPC - wood rock	MrNFEN	WE ARE THE FASTEST - Trials Fusion w_ Nick.mp4
Showni	MrSparkles	WE ARE THE FASTEST - Trials Fusion w_ Nick.mp4
Uncontested Shun	MrSparkles	WE ARE THE FASTEST - Trials Fusion w_ Nick.mp4
Ie polmier	MrSparkles	WE FINALLY GOT IT - Trials Fusion w_ Nick.mp4
ATV & Firework Lagoan	MrNFEN	WE FINALLY GOT IT - Trials Fusion w_ Nick.mp4
/ css Shanty Town	MrSparkles	WE FINALLY GOT IT - Trials Fusion w_ Nick.mp4
Sky High	MrSparkles	WE FINALLY GOT IT - Trials Fusion w_ Nick.mp4
Desert SpeedCross	MrSparkles	WE GOT SNOWMOBILES - Trials Fusion w_ Nick.mp4
Snowmobile	MrSparkles	WE GOT SNOWMOBILES - Trials Fusion w_ Nick.mp4
Yeslerday .......	MrSparkles	WE GOT SNOWMOBILES - Trials Fusion w_ Nick.mp4
Donkey Training #4	MrSparkles	WE GOT SNOWMOBILES - Trials Fusion w_ Nick.mp4
Velocity	MrSparkles	WHAT ARE THOSE! - Trials Fusion w_ Nick.mp4
— Mechu-Fusion ~	MrSparkles	WHAT ARE THOSE! - Trials Fusion w_ Nick.mp4
Purgulory rocky	MrSparkles	WHAT ARE THOSE! - Trials Fusion w_ Nick.mp4
The Hangout	MrSparkles	WHAT ARE THOSE! - Trials Fusion w_ Nick.mp4
world of warZ	MrNFEN	WORLD AT WAR - Trials Fusion w_ Nick.mp4
Mountain	MrSparkles	WORLD AT WAR - Trials Fusion w_ Nick.mp4
town exit easy version	MrSparkles	WORLD AT WAR - Trials Fusion w_ Nick.mp4
Down We Go	MrNFEN	WORLD'S MOST FRUSTRATING MAP - Trials Fusion w_ Mark & Nick.mp4
Burrow Hill (2)	Player YYFakieDualCom wins!	WORLD'S MOST FRUSTRATING MAP - Trials Fusion w_ Mark & Nick.mp4
reverse unicorn	Player YYFakieDualCom wins!	WORLD'S MOST FRUSTRATING MAP - Trials Fusion w_ Mark & Nick.mp4
[RH] neon	MrNFEN	WORLD'S MOST FRUSTRATING MAP - Trials Fusion w_ Mark & Nick.mp4
BLUE ELEMENT MITTEL	MrSparkles	YOU NEVER EXPECTED IT - Trials Fusion w_ Nick.mp4
iumper	MrSparkles	YOU NEVER EXPECTED IT - Trials Fusion w_ Nick.mp4
Donkeycous'er v2	MrNFEN	YOU NEVER EXPECTED IT - Trials Fusion w_ Nick.mp4
uberdooper	MrSparkles	YOU NEVER EXPECTED IT - Trials Fusion w_ Nick.mp4
